3
10 10
1111111111
1210000001
1010101101
1011101001
1010001011
1010111001
1010100101
1010101101
1000000131
1111111111
20 20
11111111111111111111
11000000010000000001
10211011011111011101
10110011001010011101
10111011111000100101
10000000000101110101
11011111110100000101
11010000000101111101
10011111111101000001
10100000100101110101
10101110110001010101
10100110100111000101
10110110001100011111
10100111111111000001
10101111000011110101
10100110011110010101
10110110110010110101
10110110101010110101
10000000000000001131
11111111111111111111
30 30
111111111111111111111111111111
100000000000000000000000000001
101111111110111101111101111101
100020000100100001000011000011
110101010101001101011000011001
110101010001111101000111100101
110101110110000111011100010101
110101000010110100000001000101
110111011010100101111111011101
100100011110101100000100010001
101101001000100101110111010111
101101111011110101110110010111
100001000000100001000000100001
101111011111111111111111111101
101000000000000000000000000101
101111111111111101111111011101
100000010000000001110011111101
111111010111101110101000000001
100000010100010000101111011101
101111110011011110001011010001
101111111000001110111011011111
101000001011101000000000000001
101011101011101111111111111101
101011101010000000000000000101
101010001010111101111010111001
101010101010111101000011000011
101010100011000101011010011001
101011111111010101010100113101
100000000000010001000010000101
111111111111111111111111111111
100 100
1111111111111111111111111111111111111111111111111111111111111111111111111111111111111111111111111111
